1 2 1 2 1 2 1 2 1 2 1 2 1 2 1
2 1 2 1 2 1 2 1 2 1 2 1 2 1 2
1 2 1 2 1 2 1 2 1 2 1 2 1 2 1
2 4 5 6 2 1 2 1 2 1 2 1 2 1 2
1 10 14 15 6 2 1 2 1 2 1 2 1 2 1
2 1 10 13 7 1 2 1 2 1 2 1 2 1 2
1 2 1 10 8 2 1 2 1 2 1 2 1 2 1
2 1 2 1 2 1 2 1 2 1 2 1 2 1 2
1 2 1 2 1 2 1 2 1 2 1 2 1 2 1
2 1 2 1 2 1 2 1 2 1 2 1 2 1 2