0 1 0 1 0 1 0 1 0 1 0 1 0 1 0
1 0 1 0 1 0 1 0 1 0 1 0 1 0 1
0 1 0 1 0 1 0 1 0 1 0 1 0 1 0
1 0 1 0 1 0 1 0 1 0 1 0 1 0 1
0 1 0 1 0 1 0 1 0 1 0 1 0 1 0
1 0 1 0 1 0 1 0 1 0 1 0 1 0 1
0 1 0 1 0 1 0 1 0 1 0 1 0 3 4
1 0 1 0 1 0 1 0 1 0 1 0 3 13 2
0 1 0 1 0 1 0 1 0 1 0 1 10 2 2
1 0 1 0 1 0 1 0 1 0 1 3 13 2 2
