1 2 1 2 1 2 1 2 1 2 1 2 1 2 1
2 1 2 1 2 1 2 1 2 1 2 1 2 1 2
1 2 1 2 1 2 1 2 1 2 1 2 1 2 1
2 1 2 1 2 1 2 1 2 1 2 1 2 1 2
1 2 1 2 1 2 1 2 1 2 1 2 1 2 1
2 1 2 1 2 1 2 1 2 1 2 1 2 1 2
1 2 1 2 1 2 1 2 1 2 1 2 1 4 5
2 1 2 1 2 1 2 1 2 1 2 1 4 15 3
1 2 1 2 1 2 1 2 1 2 1 2 7 3 3
2 1 2 1 2 1 2 1 2 1 2 4 15 3 3
