1 2 1 2 1 2 1 2 1 2 1 2 1 2 1
2 1 2 1 2 1 2 1 2 1 2 1 2 1 2
1 2 1 2 1 2 1 2 1 2 1 2 1 2 1
2 1 2 1 2 1 2 1 2 1 2 1 2 1 2
1 2 1 2 1 2 1 2 1 2 1 2 1 2 1
2 1 2 1 2 1 2 1 2 1 2 1 2 1 2
1 2 1 2 1 2 1 2 1 2 1 2 1 4 5
2 1 2 1 2 1 2 1 2 1 2 1 4 14 3
1 2 1 2 1 2 1 2 1 2 1 2 11 3 3
2 1 2 1 2 1 2 1 2 1 2 4 14 3 3
